#..###
..##.#.####
..#..###..#
#.........#
#......#..#
###..###..#
..#..#....#
.##.##.#.##
.#......##
.#.....##
.###@###